10 10
...T.....X
XX...XX...
X...G.....
XXXXXXX...
....X.....
XX..XGX.G.
....XXX...
XX...XX.X.
S.....G.X.
XX...XXK..
