11 13
G.....S.....G
.XXXXX.XXXXX.
.............
.XXXXX.XXXXX.
.............
.XXXXXKXXXXX.
.............
.XXXXX.XXXXX.
.............
.XXXXX.XXXXX.
G.........T.G