10 10
...T.....X
XX...XX...
X.........
XXXXXXX...
....XGG...
XX..XGX...
....XXX...
XX...XX.X.
S.......X.
XX...XXK..
